64 64
0 0 0 0 0 0 0 0 0 0 0 0 0 0 0 0 0 0 0 0 0 0 0 0 0 0 0 0 0 0 0 2048 2048 0 0 0 0 0 0 0 0 2048 2048 0 0 0 0 0 0 0 0 0 0 0 0 0 0 0 0 0 0 0 0 0 
0 0 0 0 0 0 0 0 0 0 0 0 0 0 0 0 0 0 0 0 0 0 0 0 0 0 0 0 0 0 0 0 0 0 0 0 0 0 0 0 0 0 0 0 0 0 0 0 0 0 0 0 0 0 0 0 0 0 0 0 0 0 0 0 
0 0 0 0 0 0 0 0 0 0 0 0 0 0 0 0 0 0 2048 0 0 0 0 0 0 0 0 0 0 0 0 0 0 0 0 0 0 0 0 0 0 0 0 0 0 0 0 0 0 0 0 0 0 0 0 0 0 2048 2048 2048 2048 2048 2048 2048 
0 0 0 0 0 0 0 0 0 0 0 0 0 0 0 0 0 0 2048 0 0 0 0 4 2051 2051 2051 2051 1028 0 0 0 0 0 0 0 0 0 0 0 0 0 0 0 0 0 0 0 0 0 0 0 0 0 0 0 0 2048 2048 2048 2048 2048 2048 2048 
0 0 0 0 0 0 0 0 0 0 0 0 0 0 0 0 0 0 2048 0 0 0 0 1057 247 228 163 163 1057 0 0 0 0 0 0 0 0 0 0 0 0 0 0 0 0 0 0 0 0 0 0 0 0 0 0 0 0 0 0 0 0 0 0 0 
0 0 0 0 0 0 0 0 0 0 0 0 0 0 0 0 0 0 2048 0 0 0 0 1057 230 224 163 163 1057 0 0 0 0 0 0 0 0 0 0 0 0 0 0 0 0 0 0 0 0 0 0 0 0 0 0 0 0 0 0 0 0 0 0 0 
0 0 0 0 0 0 0 0 0 0 0 0 0 0 0 0 0 0 2048 0 0 0 0 1057 226 228 224 163 1057 0 0 0 0 0 0 0 0 0 0 0 0 0 0 0 0 0 0 0 0 0 0 0 0 0 0 0 0 0 0 0 0 0 0 0 
0 0 0 0 0 0 0 0 0 0 0 0 0 0 0 0 1024 0 3072 0 0 0 0 1057 162 163 163 163 1057 0 0 0 0 0 0 0 0 0 0 0 0 0 0 0 0 0 0 0 0 0 0 0 0 0 0 0 0 0 0 0 0 0 0 0 
0 0 0 0 4 2051 2051 2051 2051 2051 2051 2051 2051 2051 2051 2051 2051 2051 2051 2051 2051 2051 2051 3083 162 163 163 163 2059 1035 2048 2048 0 0 0 0 0 0 0 0 0 0 0 0 0 0 0 0 0 0 0 0 0 0 0 0 0 0 0 0 0 0 0 0 
0 0 0 0 2081 253 253 253 253 253 253 253 253 253 253 253 253 160 160 161 161 162 162 162 162 163 163 163 163 2059 1035 2048 0 0 0 0 0 0 0 0 0 0 0 0 0 0 0 0 0 0 0 0 0 0 0 0 0 0 0 0 0 0 0 0 
0 0 0 0 2081 253 253 253 253 253 253 253 253 253 253 253 253 160 160 161 161 162 162 162 162 163 163 163 163 163 2059 1035 0 0 0 0 0 0 0 0 0 0 0 0 0 0 0 0 0 0 0 0 0 0 0 0 0 0 0 0 0 0 0 0 
0 0 0 0 2081 253 253 253 253 253 253 253 253 253 253 253 253 160 160 161 161 162 162 162 163 163 163 163 163 164 164 2059 1035 2048 2048 0 0 0 0 0 0 0 0 0 0 0 0 0 0 0 0 0 0 0 0 0 0 0 0 0 0 0 0 0 
0 0 0 0 2081 253 253 253 253 253 253 253 253 253 253 253 253 160 160 161 161 162 162 162 163 163 163 163 164 164 164 164 2059 1035 2048 2048 0 0 0 0 0 0 0 0 0 0 0 0 0 0 0 0 0 0 0 0 0 0 0 0 0 0 0 0 
0 0 0 0 2081 253 253 253 253 253 253 253 253 253 253 253 253 160 160 161 161 162 162 163 163 163 163 164 164 164 164 164 164 2059 1035 2048 0 0 0 0 0 0 0 0 0 0 0 0 0 0 0 0 0 0 0 0 0 0 0 0 0 0 0 0 
0 0 0 0 2081 253 253 253 253 253 251 253 253 253 253 253 253 160 160 161 161 162 162 163 163 163 164 164 164 164 164 165 165 165 2059 1035 0 0 0 0 0 0 0 0 0 0 0 0 0 0 0 0 0 0 0 0 0 0 0 0 0 0 0 0 
0 0 0 0 2081 253 253 253 253 253 253 253 253 253 253 253 253 160 160 161 161 162 162 163 163 164 164 164 164 165 165 165 165 165 165 2059 1035 2048 2048 0 0 0 0 0 0 0 0 0 0 0 0 0 0 0 0 0 0 0 0 0 0 0 0 0 
0 0 0 0 2081 253 253 253 253 253 253 253 253 253 253 253 253 160 160 161 161 162 162 163 164 164 164 165 165 165 165 165 165 165 165 165 2059 1035 2048 0 0 0 0 0 0 0 0 0 0 0 0 0 0 0 0 0 0 0 0 0 0 0 0 0 
0 0 0 0 2081 253 253 253 253 253 253 253 253 253 253 253 253 11 2051 2051 3 1035 163 164 164 164 165 165 165 165 165 165 165 165 165 165 165 2059 1035 0 0 0 0 0 0 0 0 0 0 0 0 0 0 0 0 0 0 0 0 0 0 0 0 0 
0 0 0 0 2081 253 253 253 253 253 253 253 253 253 253 253 253 2081 0 0 0 2059 1035 164 164 165 165 165 165 165 165 165 165 165 165 165 165 11 3083 0 0 0 0 0 2048 0 2048 2048 11 1035 2048 2048 0 0 0 0 0 0 0 0 0 0 0 0 
0 0 0 0 2081 253 253 253 253 253 253 253 253 253 253 253 253 2081 0 0 0 0 1057 165 165 165 165 165 165 165 165 165 165 165 165 165 11 3083 0 0 0 0 0 0 0 0 0 11 3083 2059 1035 2048 0 0 0 0 0 0 0 0 0 0 0 0 
0 0 0 0 2081 253 253 253 253 253 253 253 253 253 253 253 253 3105 0 0 0 0 1057 166 166 166 166 166 166 166 166 166 166 166 166 11 3083 0 0 0 0 0 0 0 0 0 11 3083 247 229 2059 1035 2048 0 0 0 0 0 0 0 0 0 0 0 
0 0 0 0 2052 3 3 3 3 3 3 3 3 3 3 3 3 3076 0 0 4 2051 3083 166 166 166 166 166 166 166 166 166 166 166 11 3083 2048 2048 2048 0 2048 2048 0 2048 11 2051 3083 172 230 224 0 2059 1035 0 0 0 0 0 0 0 0 0 0 0 
0 0 0 0 0 0 0 0 0 0 0 0 0 0 0 0 0 0 0 0 2081 249 166 166 166 166 166 166 166 166 166 166 166 11 3083 0 2048 2048 2048 0 2048 2048 2048 11 3083 171 172 172 226 228 224 11 3083 0 0 0 0 0 0 0 0 0 0 0 
0 0 0 0 0 0 0 0 0 0 0 0 0 0 0 0 0 0 0 0 2081 0 167 167 167 167 167 167 167 167 167 167 11 3083 0 0 2048 2048 2048 0 2048 2048 11 3083 171 172 172 172 173 173 11 3083 0 0 0 0 0 0 0 0 0 0 0 0 
0 0 0 0 0 0 0 0 0 0 0 0 0 0 0 0 0 0 0 0 2081 249 167 167 167 167 167 167 167 167 167 167 2059 1139 1138 0 0 0 0 0 0 11 3083 171 172 172 172 173 173 11 3083 0 0 0 0 0 0 0 0 0 0 0 0 0 
0 0 0 0 0 0 0 0 0 0 0 0 0 0 0 0 0 0 0 0 2081 167 167 167 167 167 167 167 167 167 167 168 168 2162 2163 1139 1138 0 0 0 11 3083 171 172 172 172 173 173 173 1057 0 0 0 0 0 0 0 0 0 0 0 0 0 0 
0 0 0 0 0 0 0 0 0 0 0 0 0 0 0 0 0 0 0 0 2052 3 1035 167 167 167 167 167 167 168 168 168 169 169 169 2162 2163 3 3 3 3083 171 172 172 172 173 173 173 11 3083 0 0 0 0 0 0 0 0 0 0 0 0 0 0 
0 0 0 0 0 0 0 0 0 0 0 0 0 0 0 0 0 0 0 0 0 0 1057 167 167 167 168 168 168 168 168 169 169 169 169 170 170 170 171 171 171 172 172 172 173 173 173 174 1057 1024 0 0 0 0 0 0 0 0 0 0 0 0 0 0 
0 0 0 0 0 0 0 0 0 0 0 0 0 0 0 0 0 0 0 0 0 0 1057 168 168 168 168 168 168 168 169 169 169 169 170 170 170 171 171 171 172 172 172 173 173 173 174 174 1057 0 0 0 0 0 0 0 0 0 0 0 0 0 0 0 
0 0 0 0 0 0 0 0 0 0 0 0 0 0 0 0 0 0 0 0 0 0 1057 168 168 168 168 168 168 169 169 169 169 170 170 170 171 171 171 172 172 172 173 173 173 174 174 174 1057 1024 0 0 0 0 0 0 0 0 0 0 0 0 0 0 
0 0 0 0 0 0 0 0 0 0 0 0 0 0 0 0 0 0 0 0 0 0 2059 1035 168 168 168 168 11 1139 1138 169 170 170 170 171 171 171 172 172 172 173 173 173 174 174 174 174 1057 0 0 0 0 0 0 0 0 0 0 0 0 0 0 0 
0 0 0 0 0 0 0 0 3072 3072 2048 0 0 0 0 0 0 0 0 0 0 0 0 3105 246 224 168 168 3105 2162 2163 1139 1138 170 171 171 171 172 172 172 173 173 173 174 174 175 175 175 1057 0 0 0 0 0 0 0 0 0 0 0 0 0 0 0 
0 0 0 0 2048 0 0 2048 2048 2048 2048 0 0 0 0 0 0 0 0 0 0 0 0 3105 168 168 168 168 3105 0 0 2162 2163 1090 171 171 172 172 172 173 173 173 174 174 175 175 175 175 1057 0 0 0 0 0 0 0 0 0 0 0 0 0 0 0 
0 0 0 0 2048 0 0 2048 2048 2048 2048 0 0 0 0 0 0 0 0 0 0 0 0 3105 168 168 168 168 3105 0 3072 1024 1024 2081 171 172 172 172 173 173 173 174 174 175 175 175 175 175 1057 0 0 0 0 0 0 0 0 0 0 0 0 0 0 0 
0 0 2048 2048 0 0 0 0 0 0 0 0 0 0 0 0 0 0 0 0 0 0 0 3105 168 168 168 168 3105 0 3072 3072 11 3083 172 172 172 173 173 173 174 174 175 175 175 175 175 176 2059 3075 1028 0 0 0 0 0 0 0 0 0 0 0 0 0 
0 0 3072 3072 0 0 0 0 0 0 0 0 0 0 0 0 0 0 0 0 0 0 0 2052 3 3 3 3 3076 0 3072 11 3083 246 225 172 173 173 173 174 174 175 175 175 176 176 176 176 1273 1024 3105 0 0 0 0 0 0 0 0 0 0 0 0 0 
0 0 1024 1024 0 0 0 0 0 0 0 0 0 0 0 0 0 0 0 0 0 0 0 0 0 0 0 0 0 0 11 3083 172 172 172 173 173 173 174 174 175 176 176 176 176 176 176 177 1024 1024 3105 0 0 0 0 0 0 0 0 0 0 0 0 0 
0 0 0 0 0 0 0 0 0 0 0 0 0 0 0 0 0 0 0 0 0 0 0 0 0 0 0 0 0 0 2059 1035 172 172 173 173 11 1027 1035 175 176 176 176 176 177 177 177 177 1273 1024 3105 0 0 0 0 0 0 0 0 0 0 0 0 0 
0 0 0 0 0 0 0 0 0 0 0 0 0 0 0 0 0 0 0 0 0 0 0 0 0 0 0 0 0 0 1024 2059 1035 173 173 11 3083 3072 33 176 176 176 177 177 177 177 177 177 1024 1024 3105 0 0 0 0 0 0 0 0 0 0 0 0 0 
0 0 0 0 0 0 0 0 0 0 0 0 0 0 0 0 0 0 0 0 0 0 0 0 0 0 0 0 0 0 3072 1024 2059 1035 11 3083 3072 3072 33 177 177 177 177 177 177 177 177 177 11 1027 3076 0 0 0 0 0 0 0 0 0 0 0 0 0 
0 0 0 0 0 0 0 0 0 0 0 0 0 0 0 0 0 0 0 0 0 0 0 0 0 0 0 0 0 0 3072 1024 1024 2059 3083 1024 1024 3072 33 178 178 178 178 178 178 178 178 178 1057 0 0 0 0 0 0 0 0 0 0 0 0 0 0 0 
0 0 0 0 0 0 0 0 0 0 0 0 0 0 0 0 0 0 0 0 0 0 0 0 0 0 0 0 0 0 0 0 0 0 0 0 0 3072 2081 178 178 178 178 178 178 178 178 178 1057 0 0 0 0 0 0 0 0 0 0 0 0 0 0 0 
0 0 0 0 0 0 0 0 0 0 0 0 0 0 0 0 0 0 0 0 0 0 0 0 0 0 0 0 0 0 0 0 0 4 2051 2051 2051 2051 3083 179 179 179 179 179 179 179 179 179 2059 3075 3075 3075 3075 1028 1024 1024 0 0 0 0 0 0 0 0 
0 0 0 0 0 0 0 0 0 0 0 0 0 0 0 0 0 0 0 0 0 0 0 0 0 0 0 0 0 0 0 0 0 3105 246 226 179 179 179 179 179 179 179 179 179 179 179 179 179 247 230 1024 1024 2081 1024 1024 0 0 0 0 0 0 0 0 
0 0 0 0 0 0 0 0 0 0 0 0 4 3075 3075 3075 3075 3075 3075 3075 3075 3075 3075 3075 3075 1035 1024 3072 0 0 0 0 0 3105 180 180 180 180 180 180 180 180 180 180 180 180 180 180 180 230 224 0 1024 2081 1024 1024 0 0 0 0 0 0 0 0 
0 0 0 0 0 0 0 0 0 0 0 0 2081 254 254 254 254 254 254 254 254 254 254 254 254 2059 1035 3072 0 0 0 0 0 3105 180 180 180 180 180 180 180 180 180 180 180 180 180 180 180 226 228 224 1024 2081 1024 1024 0 0 0 0 0 0 0 0 
0 0 0 0 0 0 0 0 0 0 0 0 2081 254 254 254 254 254 254 254 254 254 254 254 254 191 2059 1035 0 0 0 0 0 3105 181 181 181 181 181 181 181 181 181 181 181 181 181 181 181 181 181 181 181 2081 1024 1024 0 0 0 0 0 0 0 0 
0 0 0 0 0 0 0 0 0 0 0 0 2081 254 254 254 254 254 254 254 254 254 254 254 254 191 191 2059 1035 1024 3072 0 0 2052 3 3 3 3 1035 181 181 181 181 181 181 181 181 181 11 1027 1027 1027 1027 3076 1024 1024 0 0 0 0 0 0 0 0 
0 0 0 0 0 0 0 0 0 0 0 0 2081 254 254 254 254 254 254 254 254 254 254 254 254 191 191 190 2059 1035 1024 3072 1024 1024 1024 2048 0 11 3083 182 182 182 182 182 182 182 182 182 1057 1024 0 0 0 0 0 0 0 0 0 0 0 0 0 0 
0 0 0 0 0 0 0 0 0 0 0 0 2081 254 254 254 254 254 254 254 254 254 254 254 254 191 191 190 190 2059 1035 3072 1024 1024 1024 2048 11 3083 183 183 182 182 182 182 182 182 182 182 1057 0 0 0 0 0 0 0 0 0 0 0 0 0 0 0 
0 0 0 0 0 0 0 0 0 0 0 0 2081 254 254 254 254 254 255 254 254 254 254 254 254 191 191 190 190 189 2059 2051 2051 2051 2051 2051 3083 184 184 183 183 183 183 182 182 182 182 11 3083 0 0 0 0 0 0 0 0 0 0 0 0 0 0 0 
0 0 0 0 0 0 0 0 0 0 0 0 2081 254 254 254 254 254 254 254 254 254 254 254 254 191 191 190 190 189 189 188 188 187 187 186 186 185 184 184 183 183 183 183 183 183 11 3083 0 0 0 0 0 0 0 0 0 0 0 0 0 0 0 0 
0 0 2048 2048 0 0 0 0 0 0 0 0 2081 254 254 254 254 254 254 254 254 254 254 254 254 191 191 190 190 189 189 188 188 187 187 186 186 185 185 184 184 183 183 183 183 11 3083 0 0 0 0 0 0 0 0 0 0 0 0 0 0 0 0 0 
0 0 2048 2048 0 0 0 0 0 0 0 0 2081 254 254 254 254 254 254 254 254 254 254 254 254 191 191 190 190 189 189 188 188 187 187 186 186 185 185 184 184 184 184 183 11 3083 0 0 0 0 0 0 0 0 0 0 0 0 0 0 0 0 0 0 
0 0 0 0 0 0 0 0 0 0 0 0 2081 254 254 254 254 254 254 254 254 254 254 254 254 191 191 190 190 189 189 188 188 187 187 186 186 185 185 184 184 184 184 11 3083 0 0 0 0 0 0 0 0 0 0 0 0 0 0 0 0 0 0 0 
0 0 0 0 0 0 0 0 0 0 0 0 2081 254 254 254 254 254 254 254 254 254 254 254 254 191 191 190 190 189 189 188 188 187 187 186 186 185 185 185 184 184 11 3083 2048 2048 2048 0 0 0 0 0 0 0 0 0 0 0 0 0 0 0 0 0 
0 0 0 0 0 0 0 0 0 0 0 0 2081 254 254 254 254 254 254 254 254 254 254 254 254 191 191 190 190 189 189 188 188 187 187 186 186 185 185 185 185 11 3083 0 2048 2048 2048 0 0 0 0 0 0 0 0 0 0 0 0 0 0 0 0 0 
0 0 0 0 0 0 0 0 0 0 0 0 2052 3075 3075 3075 3075 3075 3075 3075 3075 3075 3075 3075 3075 3075 3075 3075 3075 3075 3075 3075 3075 3075 3075 3075 3075 3075 3075 3075 3075 3083 0 0 2048 2048 2048 0 0 0 0 0 0 0 0 0 0 0 0 0 0 0 0 0 
0 0 0 0 0 0 0 0 0 0 0 0 0 0 0 0 0 0 0 0 0 0 0 0 0 0 0 0 0 0 0 0 0 0 0 0 0 0 0 0 0 0 0 0 0 0 0 0 0 0 0 0 0 0 0 0 0 0 0 0 0 0 0 0 
0 0 0 0 0 0 0 0 0 0 0 0 0 0 0 0 0 0 0 0 0 0 0 0 0 0 0 0 0 0 0 0 0 0 0 0 0 0 0 0 0 0 0 0 0 0 0 0 0 0 0 0 0 0 0 0 0 0 0 0 0 0 0 0 
0 0 0 0 0 0 0 0 0 0 0 0 0 0 0 0 0 0 0 0 0 0 0 0 0 0 0 0 0 0 0 0 0 0 0 0 0 0 0 0 0 0 0 0 0 0 0 0 0 0 0 0 0 0 0 0 0 0 0 0 0 0 0 0 
0 0 0 0 0 0 0 0 0 0 0 0 0 0 0 0 0 0 0 0 0 0 0 0 0 0 0 0 0 0 0 0 0 0 0 0 0 0 0 0 0 0 0 0 0 0 0 0 0 0 0 0 0 0 0 0 0 0 0 0 0 0 0 0 
0 0 0 0 0 0 0 0 0 0 0 0 0 0 0 0 0 0 0 0 0 0 0 0 0 0 0 0 0 0 0 0 0 0 0 0 0 0 0 0 0 0 0 0 0 0 0 0 0 0 0 0 0 0 0 0 0 0 0 0 0 0 0 0 
0 0 0 0 0 0 0 0 0 0 0 0 0 0 0 0 0 0 0 0 0 0 0 0 0 0 0 0 0 0 0 0 0 0 0 0 0 0 0 0 0 0 0 0 0 0 0 0 0 0 0 0 0 0 0 0 0 0 0 0 0 0 0 0 
