128 64
226 225 0 225 224 225 0 225 225 0 0 0 0 0 0 0 0 0 0 0 0 0 0 0 2048 2048 2048 2048 2048 0 0 0 0 0 0 0 0 0 0 0 0 0 0 0 0 0 0 0 0 0 0 0 0 0 0 0 0 0 0 0 0 0 0 0 0 0 0 0 0 0 0 0 0 0 0 0 0 0 0 2048 2048 2048 2048 2048 2048 2048 3072 3072 3072 3072 3072 3072 3072 0 0 0 0 0 0 0 0 0 0 0 0 0 0 0 0 0 0 0 0 0 0 0 0 0 0 0 0 0 0 0 0 0 0 0 
0 0 0 0 0 0 0 0 0 0 0 0 0 0 0 0 0 0 0 0 0 0 0 0 2048 2048 2048 2048 0 2048 2048 114 115 3075 1027 3075 1027 1027 1139 1138 1024 1024 1024 1024 0 0 0 0 0 0 0 0 0 0 0 0 0 0 0 0 0 0 0 0 0 0 0 0 0 0 0 0 0 0 0 0 0 0 0 2048 2048 2048 2048 2048 2048 2048 3072 3072 3072 3072 3072 3072 3072 0 0 0 0 0 0 0 0 0 0 0 0 0 0 0 0 0 0 0 0 0 0 0 0 0 0 0 0 0 0 0 0 0 0 0 
0 0 0 0 0 0 0 0 0 0 0 0 0 0 0 0 0 0 0 0 0 0 0 0 0 0 0 0 0 114 115 3187 3186 0 0 0 0 0 2162 2163 1139 1138 3072 3072 0 0 0 0 0 0 0 0 0 0 0 0 0 0 0 0 0 0 0 0 0 0 0 0 0 0 0 0 0 0 0 0 0 0 2048 2048 2048 3072 3072 3072 2048 3072 2048 2048 2048 3072 3072 3072 0 0 0 0 0 0 0 0 0 0 0 0 0 0 0 0 0 0 0 0 0 0 0 0 0 0 0 0 0 0 0 0 0 0 0 0 
0 0 0 0 0 0 0 0 0 0 0 0 0 0 0 0 0 0 0 0 0 0 0 0 0 0 2048 2048 11 3187 3186 2048 2048 0 0 0 0 0 0 0 2162 2163 1139 1138 0 0 0 0 0 0 0 0 0 0 0 0 0 0 0 0 0 0 0 0 0 0 0 0 0 0 0 0 0 0 0 0 0 0 0 0 2048 2048 11 3 3 3 1027 3 1027 1027 1027 1035 3072 3072 0 0 0 0 0 0 0 0 0 0 0 0 0 0 0 0 0 0 0 0 0 0 0 0 0 0 0 0 0 0 0 0 0 0 
0 0 0 0 0 0 0 0 0 0 0 0 0 0 0 0 0 0 0 0 0 0 0 2048 2048 2048 2048 11 3083 0 0 0 0 0 0 0 1024 1024 1024 0 3072 3072 2162 2163 1035 1024 1024 1024 1024 0 0 0 0 0 0 0 0 0 0 0 0 0 0 0 0 0 0 0 0 0 0 0 0 0 0 0 0 0 0 0 2048 11 3083 2048 2048 2048 2048 3072 3072 3072 3072 2059 1035 3072 0 0 0 0 0 0 0 0 0 0 0 0 0 0 0 0 0 0 0 0 0 0 0 0 0 0 0 0 0 0 0 0 0 0 
0 0 0 0 0 0 0 0 0 0 0 0 0 0 0 0 0 0 0 0 0 0 0 2048 2048 2048 11 3083 2048 0 0 0 0 0 0 0 1024 1024 1024 0 1024 1024 1024 1024 2059 1035 1024 1024 0 0 0 0 0 0 0 0 0 0 0 0 0 0 0 0 0 0 0 0 0 0 0 0 0 0 0 0 0 0 0 0 11 3083 2048 2048 2048 2048 2048 3072 3072 3072 3072 3072 2059 1035 0 0 0 0 0 0 0 0 0 0 0 0 0 0 0 0 0 0 0 0 0 0 0 0 0 0 0 0 0 0 0 0 0 0 
0 0 0 0 0 2048 0 0 0 0 0 0 0 0 0 0 0 0 0 0 0 0 0 2048 2048 11 3083 2048 0 0 3072 3072 179 187 196 196 1220 1211 1203 1024 1024 1024 1024 1024 1024 2059 1035 1024 1024 0 0 0 0 0 0 0 0 0 0 0 0 0 0 0 0 0 0 0 0 0 0 0 0 0 0 0 114 115 3075 3075 3083 2048 2048 2048 2048 2048 2048 3072 3072 3072 3072 3072 3072 2059 3075 3075 3075 3075 3075 2051 1139 1138 3072 3072 0 0 0 0 0 0 0 0 0 0 0 0 0 0 0 0 0 0 0 0 0 0 0 0 
0 0 0 0 0 2048 0 0 0 0 0 0 0 0 0 0 0 0 0 0 0 0 0 2048 11 3083 2048 3072 0 0 3072 163 3257 185 2244 2244 3268 1209 2233 1211 1203 2048 2048 1024 1024 1024 2059 1035 1024 0 0 0 0 0 0 0 0 0 0 0 0 0 0 0 0 0 0 0 0 0 0 0 2048 2048 114 115 3187 3186 0 0 2048 2048 2048 2048 0 0 0 0 0 0 0 3072 3072 3072 0 0 0 0 0 1024 2162 2163 1139 1138 0 0 0 0 0 0 0 0 0 0 0 0 0 0 0 0 0 0 0 0 0 0 0 0 
0 0 0 0 0 2048 0 0 0 0 0 0 0 0 0 0 0 0 0 0 0 0 0 29 3133 2048 2048 2048 3072 3072 163 3237 3259 3251 2048 2048 3072 2227 2235 1209 2233 1187 2048 2048 2048 1024 1024 2059 1035 0 0 0 0 0 0 0 0 0 0 0 0 0 0 0 0 0 0 0 0 0 2048 2048 114 115 3187 3186 1024 1024 0 0 0 0 0 0 0 0 0 0 0 0 0 0 0 1024 0 0 1024 1024 1024 1024 3072 3072 2162 2163 1139 1138 3072 3072 3072 1024 1024 0 0 0 0 0 0 0 0 0 0 0 0 0 0 0 0 0 
0 0 0 0 0 2048 0 0 0 0 0 0 0 0 0 0 0 0 0 0 0 0 0 61 3101 2048 2048 2048 0 163 3237 3235 3072 3072 2048 2048 3072 3072 2048 2227 2235 2213 1187 2048 2048 1024 1024 1024 2109 1053 0 0 0 0 0 0 0 0 0 0 0 0 0 0 0 0 0 0 0 0 114 115 3187 3186 2048 2048 1024 0 0 0 0 0 0 0 192 196 1220 1220 1220 1216 0 0 0 0 0 0 0 0 0 0 1024 1024 1024 1024 2162 2163 1035 0 3072 1024 1024 0 0 0 0 0 0 0 0 0 0 0 0 0 0 0 0 0 
0 0 0 0 0 2048 0 0 0 0 0 0 0 0 0 0 0 0 0 0 0 0 0 2081 0 0 0 0 209 214 3288 3072 3072 3072 2048 2048 3072 3072 2048 3072 2048 2211 2213 1187 2048 1024 1024 1024 2077 1085 0 0 0 0 0 0 0 0 0 0 0 0 0 0 0 0 0 0 0 11 3187 3186 2048 2048 1024 0 0 0 0 0 0 0 0 0 1224 201 202 202 1225 200 0 0 0 0 0 0 0 0 0 0 1024 1024 1024 1024 3072 3072 2059 1035 0 0 0 0 0 0 0 0 0 0 0 0 0 0 0 0 0 0 0 0 
0 0 0 0 0 2048 0 0 0 0 0 0 0 0 0 0 0 0 0 0 0 0 0 2081 0 0 0 2048 216 3286 3281 2048 2048 0 0 0 0 1024 2048 3072 2048 2048 2211 2213 1187 1024 1024 1024 0 2109 1053 0 0 0 0 0 0 0 0 0 0 0 0 0 0 0 0 0 11 3083 0 0 0 0 1024 0 0 0 0 0 0 0 0 0 2240 2244 3268 3268 3268 3264 0 0 0 1024 0 0 1024 1024 1024 1024 1024 1024 1024 1024 1024 1024 1024 2059 1035 1024 1024 0 0 0 0 0 0 0 0 0 0 0 0 0 0 0 0 0 
0 0 0 0 0 0 0 0 0 0 0 0 0 0 0 0 0 0 0 0 2048 2048 0 2081 0 0 0 0 3272 2248 2048 2048 2048 0 11 1027 1139 1138 3072 3072 2048 2048 2048 2264 1238 1233 3072 3072 0 2077 1085 0 0 0 0 0 0 0 0 0 0 0 0 0 0 0 0 11 3083 0 0 0 0 0 0 0 0 0 0 0 0 0 0 0 0 0 0 0 0 1024 0 0 0 1024 0 0 1024 1024 1024 1024 1024 1024 1024 1024 1024 1024 1024 1024 2109 1053 3072 0 0 0 0 0 0 0 0 0 0 0 0 0 0 0 0 0 
0 0 0 0 0 2048 2048 2048 2048 2048 2048 2048 2048 2048 2048 2048 2048 2048 2048 2048 114 115 1027 3083 0 0 0 0 3272 2248 2048 0 0 0 2081 0 2162 2163 1035 1024 0 1024 3072 2257 2262 1240 3072 3072 0 0 2109 1053 0 0 0 2048 0 0 0 0 0 0 0 0 1024 1024 11 3083 0 0 0 0 0 0 0 0 0 0 0 0 0 0 0 0 0 0 0 0 0 0 1024 1024 1024 1024 0 0 1024 1024 1024 1024 1024 1024 1024 1024 1024 1024 1024 1024 2077 1085 3072 0 0 0 0 0 0 0 0 0 0 0 0 0 0 0 0 0 
0 0 0 0 0 2048 2048 2048 2048 2048 2048 2048 2048 2048 0 0 2048 2048 114 115 3187 3186 0 0 0 0 0 0 2240 3264 2048 0 0 0 2081 0 3072 3072 2059 1035 0 1024 0 2048 2264 1238 1233 3072 0 0 2077 1085 0 0 0 2048 0 0 0 0 0 0 0 0 1024 29 3133 1024 0 0 0 0 0 0 0 0 114 115 3075 3075 1035 0 0 0 0 0 0 1024 1024 1024 1024 1024 1024 11 3075 3075 1139 1138 1024 1024 1024 1024 1024 1024 1024 1024 1024 1024 3072 2109 1053 0 0 0 0 0 0 0 0 0 0 0 0 0 0 0 0 0 
0 0 0 0 0 2048 2048 2048 2048 2048 2048 2048 2048 2048 2048 2048 114 115 3187 3186 2048 2048 0 0 0 0 0 0 0 0 0 0 0 0 2081 0 3072 3072 1024 2109 1053 1024 0 3072 2257 2262 1240 3072 0 0 0 2081 0 0 0 0 0 0 0 0 0 0 0 0 1024 61 3101 1024 0 0 0 0 0 0 2048 11 3187 3186 0 0 2059 1035 0 0 0 0 0 1024 1024 1024 1024 1024 11 3083 0 0 2162 2163 1035 3072 1024 1024 0 0 0 0 0 1024 3072 2077 1085 0 0 0 0 0 0 0 0 0 0 0 0 0 0 0 0 0 
0 0 0 0 0 2048 2048 2048 2048 2048 2048 2048 2048 2048 114 115 3187 3186 2048 2048 2048 2048 0 0 0 0 0 0 0 0 0 0 0 0 2081 0 1024 0 1024 2077 1085 1024 0 3072 0 1224 200 0 0 0 0 3105 0 0 0 0 0 0 0 0 0 0 1024 1024 29 3133 1024 0 0 0 0 0 2048 2048 29 3133 1024 1024 0 0 0 2059 1035 0 0 0 0 1024 1024 1024 1024 11 3083 1024 0 0 0 0 2109 1053 3072 3072 1024 1024 0 0 1024 1024 3072 1024 2081 0 0 0 0 0 0 0 0 0 0 0 0 0 0 0 0 0 
0 0 0 0 0 2048 2048 2048 2048 2048 2048 2048 2048 11 3187 3186 2048 2048 2048 2048 0 0 0 0 0 0 0 0 0 0 0 0 0 0 2081 0 1024 0 0 0 2081 0 0 1024 0 1224 200 0 0 0 0 3105 0 0 0 0 0 0 0 0 0 0 1024 1024 61 3101 1024 0 0 0 0 0 0 0 61 3101 0 0 0 0 0 0 2059 2051 2051 2051 3075 2051 3075 3075 3075 3083 1024 1024 0 0 1024 1024 2077 1085 1024 1024 1024 1024 192 1216 1024 1024 1024 1024 2081 0 0 0 0 0 0 0 0 0 0 0 0 0 0 0 0 0 
0 0 0 0 0 2048 2048 2048 2048 2048 2048 2048 11 3083 2048 2048 2048 2048 2048 2048 2048 2048 2048 2048 0 2048 2048 2048 2048 0 0 0 0 0 2081 0 0 0 0 0 3105 1024 0 1024 0 1224 200 0 0 0 0 3105 0 0 0 0 0 0 0 0 0 0 1024 29 3133 1024 1024 0 0 0 0 0 0 0 3105 0 0 0 0 0 0 0 0 1024 1024 1024 0 1024 0 0 0 1024 1024 1024 0 0 1024 1024 1024 2081 1024 1024 1024 1024 1224 200 1024 1024 1024 1024 2081 0 0 0 0 0 0 0 0 0 0 0 0 0 0 0 0 0 
0 0 0 0 0 2048 2048 2048 2048 2048 2048 11 3083 2048 2048 3072 0 0 0 0 0 0 0 0 0 2048 2048 114 115 1027 1027 1027 1027 1027 3083 0 0 0 0 0 3105 1024 1024 1024 3072 3272 2248 3072 0 0 0 3105 0 0 0 0 0 0 0 0 0 0 1024 61 3101 1024 1024 3072 0 0 0 0 0 2048 3105 0 2048 0 0 0 0 0 0 0 0 0 0 0 0 1024 1024 1024 1024 1024 1024 1024 1024 3072 1024 2081 3072 1024 0 0 1224 200 0 1024 3072 1024 2081 3072 0 0 0 0 0 0 0 0 0 0 0 0 0 0 0 0 
0 0 0 0 0 2048 2048 2048 2048 2048 11 3083 2048 3072 3072 3072 0 0 0 0 0 2048 2048 2048 2048 114 115 3187 3186 0 0 0 0 0 0 0 0 0 0 0 3105 1024 1024 1024 3072 2240 3264 3072 0 0 0 2109 1053 0 0 0 0 0 0 0 0 0 29 3133 1024 1024 1024 1024 212 213 0 0 0 2048 3105 0 2048 0 0 0 0 0 0 0 0 0 0 0 0 1024 1024 1024 1024 1024 1024 1024 1024 1024 1024 2081 1024 1024 2048 2048 1224 200 2048 1024 1024 0 2109 1053 0 0 0 0 0 0 0 0 0 0 0 0 0 0 0 0 
0 0 0 0 0 2048 2048 2048 2048 11 3083 2048 0 0 0 3072 163 164 0 0 0 2048 2048 2048 11 3187 3186 2048 2048 0 0 0 0 0 0 0 0 0 0 0 3105 1024 1024 0 1024 1024 1024 0 0 0 0 2077 1085 0 0 0 0 0 0 0 1024 1024 61 3101 1024 0 0 209 214 3288 0 0 0 2048 3105 0 0 0 0 0 0 0 0 0 0 0 0 0 0 1024 1024 1024 1024 1024 1024 1024 0 0 1024 2081 3072 0 0 0 3272 2248 0 0 0 0 2077 1075 1139 1138 0 0 0 0 0 0 0 0 0 0 0 0 0 0 
0 0 0 0 0 2048 2048 2048 11 3083 2048 3072 0 0 0 163 165 3235 0 0 0 2048 2048 11 3083 2048 2048 2048 2048 0 0 0 0 0 0 0 0 0 0 0 3105 0 0 0 0 0 0 0 0 0 0 0 2109 1053 0 0 0 0 0 0 1024 29 3133 1024 1024 0 0 216 3286 3281 0 0 0 0 3105 0 0 0 0 0 0 0 0 0 0 0 0 0 0 0 0 0 0 0 0 0 0 0 1024 2081 1024 0 2048 2048 3272 2248 2048 0 0 0 0 0 2162 2163 1035 0 0 0 0 0 0 0 0 0 0 0 0 0 
0 0 0 0 0 2048 2048 29 3133 0 0 0 0 0 163 3237 3235 3072 0 2048 2048 2048 11 3083 2048 0 0 0 0 0 0 0 0 0 0 0 0 0 0 0 3105 0 0 0 0 0 0 0 0 0 0 0 2077 1085 0 0 0 0 0 0 1024 61 3101 1024 1024 0 209 214 3288 0 0 0 0 2048 3105 0 0 0 0 0 0 0 0 0 0 0 0 0 0 0 0 0 0 0 0 0 0 0 1024 2081 1024 0 2048 2048 2240 3264 2048 0 0 0 0 0 3072 3072 2059 1035 2048 0 0 0 0 0 0 0 0 0 0 0 
0 0 0 0 0 2048 2048 61 3101 2048 3072 3072 0 209 214 3288 0 0 0 2048 2048 11 3083 2048 3072 0 0 0 0 0 0 0 0 0 0 0 0 0 0 0 2059 1035 2048 2048 2048 2048 2048 0 0 0 0 0 0 2109 1053 0 0 0 0 0 29 3133 1024 1024 1024 0 216 3286 3281 0 0 0 0 0 3105 0 2048 0 0 0 0 0 0 0 0 0 0 0 0 0 0 0 0 0 0 0 0 0 1024 2081 3072 0 0 0 0 0 0 0 0 0 0 0 0 2048 2048 2059 1035 0 0 0 0 0 0 0 0 0 0 0 
0 0 0 0 0 2048 29 3133 2048 2048 2048 0 0 216 3286 3281 0 0 0 2048 11 3083 2048 0 0 0 0 0 0 0 0 0 0 0 0 0 0 0 0 0 0 2059 3075 3 3 1035 2048 0 0 0 0 0 0 2077 1085 0 0 0 0 0 61 3101 1024 1024 1024 0 3285 3284 2048 0 0 0 2048 11 3083 0 0 0 0 0 0 0 0 0 0 0 0 0 0 0 0 0 0 0 0 0 0 0 1024 2081 3072 0 0 0 0 0 0 0 0 0 0 0 0 0 0 0 2059 1035 2048 0 0 0 0 0 0 0 0 0 
0 0 0 0 0 2048 61 3101 2048 2048 2048 0 209 214 3288 0 2048 2048 0 11 3083 2048 3072 2048 2048 0 0 0 0 0 0 0 0 0 0 0 0 0 0 0 0 1024 2048 2048 2048 2059 1035 2048 0 0 0 0 0 0 2109 1053 0 0 0 0 3105 0 0 0 0 0 0 0 2048 2048 2048 2048 11 3083 0 0 0 0 0 0 0 0 0 0 0 0 0 0 0 0 0 0 0 0 0 0 0 0 0 2059 1035 3072 0 0 0 0 0 0 0 0 0 0 0 0 0 0 0 2109 1053 0 0 0 0 0 0 0 0 0 
0 0 0 0 0 2048 2081 0 2048 2048 2048 0 216 3286 3281 0 2048 2048 29 3133 2048 3072 0 0 0 0 0 0 0 0 0 0 0 0 0 0 0 0 0 0 0 0 2048 2048 2048 2048 2059 1035 0 0 0 0 0 0 2077 1085 0 0 0 0 1057 2048 0 0 0 0 0 0 2048 0 0 11 3083 0 0 0 0 0 0 0 0 0 0 0 0 0 0 0 0 0 0 0 0 0 0 0 0 0 0 1024 2059 1035 0 0 0 0 0 0 0 0 0 0 0 0 0 0 0 2077 1085 0 0 0 0 0 0 2048 0 0 
0 0 0 0 0 2048 2081 0 2048 2048 2048 0 3272 2248 2048 0 2048 2048 61 3101 2048 0 0 0 0 0 0 0 0 0 0 0 0 0 0 0 0 0 0 0 2048 0 2048 2048 2048 2048 2048 2109 1053 0 0 0 0 0 0 2081 0 0 0 0 3105 0 0 0 0 0 2048 2048 2048 2048 11 3083 2048 2048 0 0 0 0 0 0 0 0 0 0 0 0 0 0 0 0 0 0 0 0 0 0 0 0 0 0 1024 2059 2051 2051 3075 3075 1139 1138 3072 3072 0 0 0 0 0 0 0 0 2109 1053 0 0 0 0 0 0 0 0 
0 0 0 0 0 0 2081 0 2048 2048 2048 0 3272 2248 2048 2048 2048 2048 2081 0 2048 2048 2048 2048 0 0 0 0 0 0 0 0 0 0 0 0 0 0 0 0 0 0 0 0 0 0 2048 2077 1085 0 0 0 0 0 0 3105 0 0 0 0 1057 2048 0 0 0 0 2048 2048 2048 29 3133 2048 2048 2048 0 2048 2048 0 0 0 0 0 0 0 0 0 0 0 0 0 0 0 0 0 0 0 0 0 0 0 0 0 1024 1024 0 0 2162 2163 1139 1138 1024 0 0 0 0 0 0 0 2077 1085 0 0 0 0 0 0 0 0 
0 0 0 0 0 0 2081 0 2048 2048 0 0 1224 200 0 0 0 0 33 2048 0 0 0 0 0 0 0 0 0 0 0 0 0 0 0 0 0 0 0 0 0 0 0 0 0 0 0 0 2081 0 0 0 0 0 0 2081 0 0 0 0 3105 0 2048 0 0 0 0 0 0 61 3101 2048 2048 2048 2048 2048 2048 2048 2048 0 0 0 0 0 0 0 0 0 0 0 0 0 0 0 0 0 0 0 0 0 0 0 0 1024 1024 1024 3072 3072 2162 2163 1035 0 0 0 0 0 0 0 0 2081 0 0 0 0 0 0 0 0 
0 0 0 0 0 0 2081 0 2048 2048 0 0 1224 200 0 2048 0 0 2109 1053 0 0 0 0 0 0 0 0 0 0 0 0 0 0 0 0 0 0 0 0 0 0 0 0 0 0 0 0 3105 0 0 0 0 0 0 2081 0 0 0 0 2109 1053 0 0 0 0 0 0 0 1057 2048 2048 2048 2048 2048 2048 2048 2048 2048 0 0 0 0 0 0 0 0 0 0 0 0 0 0 0 0 0 0 0 0 0 0 0 0 0 0 0 0 0 0 0 2109 1053 0 0 0 0 0 0 0 2081 0 0 0 0 0 0 0 0 
0 0 0 0 0 0 33 2048 0 0 0 0 2264 1238 1233 2048 0 0 2077 1085 0 0 2048 2048 0 0 0 0 0 0 0 0 0 0 0 0 0 0 0 0 0 0 0 0 0 0 0 0 3105 0 0 0 0 0 0 3105 0 0 0 0 2077 1085 0 0 0 0 0 0 0 1057 2048 2048 2048 2048 2048 2048 2048 2048 2048 0 0 0 0 0 0 0 0 0 0 0 0 0 0 0 0 0 0 0 0 0 0 0 0 0 0 0 0 0 0 0 2077 1085 0 0 0 0 0 0 0 2081 0 0 0 0 0 0 0 0 
0 0 0 0 0 0 33 2048 0 0 0 0 2257 2262 1240 2048 0 0 0 2059 1139 1138 0 0 0 0 0 0 0 0 0 0 0 0 0 0 0 0 0 0 0 0 0 0 0 0 0 0 3105 0 0 0 0 0 0 3105 0 0 0 0 0 2109 1053 0 0 0 0 0 0 2059 1035 0 0 0 0 0 0 0 0 0 0 0 0 0 0 0 0 0 0 0 0 0 0 0 0 0 0 0 0 0 0 0 2048 2048 2048 2048 2048 2048 2048 2048 2048 33 0 0 0 0 0 0 0 2081 0 0 0 0 0 0 0 0 
0 0 0 0 0 0 2109 1053 0 0 0 0 2048 2264 1238 1233 2048 0 0 0 2162 2163 3075 1027 1027 1027 1027 1027 1027 1027 1027 1027 1027 1027 1027 1027 1035 0 0 0 0 0 0 0 0 0 0 29 3133 0 0 0 0 0 0 3105 0 0 0 0 0 2077 1085 0 0 0 0 0 0 0 2059 3075 3 1027 1027 2051 2051 1035 0 0 0 0 0 0 0 0 0 0 0 0 0 0 0 0 0 0 0 0 0 0 0 0 2048 2048 2048 2048 2048 2048 2048 2048 2048 33 0 0 0 0 0 0 0 2081 0 0 0 0 0 0 0 0 
0 0 0 0 0 0 2077 1085 0 0 0 0 2048 2257 2262 1240 2048 0 0 0 0 0 0 0 0 0 0 0 0 0 0 0 0 0 0 0 2081 0 0 0 0 0 0 0 0 0 0 61 3101 0 0 0 0 0 29 3133 0 0 0 0 0 0 2059 1035 2048 0 0 0 1024 0 0 0 0 0 0 0 0 2059 1035 2048 0 0 0 0 0 0 0 0 0 0 0 0 0 0 0 0 0 0 0 0 0 0 2048 2048 2048 2048 2048 2048 2048 2048 2048 33 0 0 0 0 0 0 0 2081 0 0 0 0 0 0 0 0 
0 0 0 0 0 2048 0 2109 1053 0 1024 1024 2048 2048 2211 1189 1187 0 0 0 0 0 0 0 0 0 0 0 0 0 0 0 0 0 0 0 2081 0 0 0 2048 0 0 0 0 0 11 3083 0 0 0 0 0 0 61 3101 0 0 0 0 0 0 0 2059 1035 2048 0 0 0 0 0 0 0 0 0 0 0 0 2059 1035 0 0 0 0 0 0 0 0 0 0 0 0 0 0 0 0 0 0 0 0 0 0 2048 2048 2048 2048 2048 2048 2048 2048 29 3133 2048 2048 2048 2048 2048 2048 2048 33 0 0 0 0 0 0 0 0 
0 0 0 0 0 2048 0 2077 1085 0 0 1024 2048 2048 2048 2211 1189 1187 2048 2048 0 0 0 0 0 0 0 0 0 0 0 0 2048 2048 2048 11 3083 0 0 2048 2048 0 0 0 0 11 3083 0 0 0 0 2048 2048 29 3133 0 0 0 0 0 0 0 0 0 2059 1035 0 0 0 0 0 0 0 0 0 0 0 0 0 3105 0 0 0 0 0 0 0 0 0 0 0 0 0 0 0 0 0 0 0 0 0 0 0 2048 2048 2048 2048 2048 2048 2048 61 3101 2048 2048 2048 2048 2048 2048 2048 33 0 0 0 0 0 0 0 0 
0 0 0 0 0 0 0 0 2059 1035 0 0 0 1024 1024 2048 2211 2213 1211 1203 0 0 0 0 0 0 0 0 0 0 2048 0 2048 2048 11 3083 2048 0 2048 0 0 0 0 0 11 3083 0 0 0 0 0 2048 2048 61 3101 0 0 0 0 0 0 0 0 0 0 2059 1035 2048 0 0 0 0 0 0 0 0 0 0 0 3105 0 2048 0 0 0 0 0 0 0 11 3 3 3 3 3 3 3 3 3 3 3 3 1035 3072 3072 3072 3072 1024 114 115 3083 2048 2048 2048 2048 2048 2048 2048 29 3133 0 0 0 0 0 0 0 0 
0 0 0 0 0 0 0 0 0 2059 1035 0 0 1024 1024 1024 1024 2211 1209 2233 196 196 1220 196 196 196 196 1216 0 0 2048 2048 2048 11 3083 0 0 2048 2048 0 0 0 0 11 3083 0 0 0 0 0 0 2048 29 3133 0 3072 0 0 0 0 0 0 0 0 0 0 2059 1035 0 0 0 0 0 192 1216 0 0 0 2048 3105 0 0 0 0 0 0 0 0 0 3105 254 254 254 254 254 254 254 254 254 254 254 254 2059 1027 1027 1027 1027 1027 3187 3186 3072 2048 2048 2048 2048 2048 2048 2048 61 3101 0 0 0 0 0 0 0 0 
0 0 0 0 0 0 0 0 0 0 2059 1035 0 0 1024 0 0 2048 2227 2235 2244 2244 3268 2244 2244 2244 2244 3264 0 0 2048 2048 29 3133 2048 2048 2048 2048 0 0 0 0 11 3083 0 0 0 0 0 0 0 2048 61 3101 0 3072 0 0 0 0 0 0 0 0 0 0 0 2059 1035 0 0 0 0 1224 200 0 0 0 2048 3105 0 0 0 0 0 0 0 0 0 3105 254 254 254 254 254 254 254 254 254 254 254 254 1024 0 0 0 0 0 1024 1024 2048 2048 2048 2048 2048 2048 2048 29 3133 2048 0 0 0 0 0 0 0 0 
0 0 0 0 0 0 0 0 0 0 0 2059 1035 0 0 1024 1024 1024 1024 0 0 0 0 2048 2048 2048 2048 2048 0 0 2048 0 61 3101 0 2048 0 0 0 0 0 11 3083 0 0 0 0 0 0 0 0 29 3133 0 3072 3072 3072 0 0 0 0 0 0 0 0 0 0 0 3105 0 0 0 0 1224 200 0 0 0 0 3105 0 0 0 0 0 0 0 0 0 3105 254 254 254 254 254 254 254 254 254 254 254 254 0 0 0 0 0 0 0 0 0 0 2048 2048 2048 2048 2048 61 3101 2048 0 0 0 0 0 0 0 0 
0 0 0 0 0 0 0 0 0 0 0 0 2059 1035 0 0 0 0 0 0 0 0 0 0 0 0 0 0 0 0 0 29 3133 0 3072 2048 0 2048 0 0 11 3083 0 0 0 0 0 0 0 0 0 61 3101 0 3072 0 2048 0 0 2048 0 0 0 0 0 0 0 0 3105 0 0 0 0 3272 2248 0 0 0 0 3105 0 0 0 0 0 0 0 0 0 1057 254 254 254 254 254 254 254 254 254 254 254 254 0 0 0 0 0 0 0 0 0 0 2048 2048 2048 2048 11 3083 0 2048 0 0 0 0 0 0 0 0 
0 0 0 0 0 0 0 0 0 0 0 0 0 2059 1139 1138 0 0 0 0 0 0 0 0 0 0 0 0 0 0 0 61 3101 0 0 0 0 0 0 11 3083 0 0 0 0 0 0 0 0 0 0 3105 0 0 0 0 2048 0 0 0 0 3072 3072 2048 0 0 0 0 1057 2048 2048 2048 2048 3272 2248 2048 2048 2048 2048 3105 0 0 0 0 0 0 0 0 0 1057 254 254 254 254 254 254 254 254 254 254 254 254 0 0 0 0 0 0 0 0 0 0 2048 2048 0 11 3083 2048 2048 2048 0 0 0 0 0 0 0 0 
0 0 0 0 0 0 0 0 0 0 0 0 0 0 2162 2163 1139 1138 0 0 0 0 0 0 0 0 0 0 0 0 0 2081 0 2048 2048 2048 2048 0 11 3083 0 0 0 0 0 0 0 0 0 0 0 2081 0 0 2048 114 115 1027 1027 2051 2051 3075 3075 1027 2051 2051 3075 1027 3083 2048 2048 2048 2048 1224 200 2048 2048 2048 2048 3105 0 0 0 0 0 0 0 0 0 3105 254 254 254 254 254 255 254 254 254 254 254 254 0 0 0 0 0 0 0 0 0 0 1024 1024 11 3083 0 2048 2048 2048 0 0 0 0 0 0 0 0 
0 0 0 0 0 0 0 0 0 0 0 0 1024 1024 0 0 2162 2163 1139 1138 0 0 0 0 0 0 0 0 0 0 0 2081 0 0 2048 2048 0 0 2081 0 0 0 0 0 0 0 0 0 0 0 0 3105 0 0 11 3187 3186 0 0 1024 1024 0 0 0 1024 1024 0 0 0 0 0 0 0 1224 200 0 0 0 0 1057 0 0 0 0 0 0 0 0 0 1057 254 254 254 254 254 254 254 254 254 254 254 254 0 0 0 0 0 0 0 0 1024 1024 114 115 3083 2048 2048 2048 2048 2048 0 0 0 0 0 0 0 0 
0 0 0 0 0 0 0 0 0 0 0 0 0 0 0 0 0 0 2162 2163 1027 1027 1035 0 0 0 0 0 0 0 0 33 2048 2048 0 0 2048 0 2081 234 234 234 234 234 234 234 234 234 234 234 234 2059 3075 1027 3083 0 0 0 0 0 0 0 0 0 0 0 0 0 0 0 0 0 0 1224 200 0 0 0 0 3105 0 0 0 0 0 0 0 0 0 1057 254 254 254 254 254 254 254 254 254 254 254 254 0 0 0 0 0 0 0 0 114 115 3187 3186 2048 2048 2048 2048 2048 2048 0 0 0 0 0 0 0 0 
0 0 0 0 0 0 0 0 0 0 0 0 0 0 0 0 0 0 0 0 0 0 2081 0 0 0 0 0 0 0 0 33 2048 0 0 0 0 0 2081 234 234 234 234 234 234 234 234 234 234 234 234 0 0 0 0 0 0 0 0 0 0 0 0 0 0 0 0 0 0 0 0 0 0 1224 200 0 0 0 0 3105 0 0 0 0 0 0 0 0 0 3105 254 254 254 254 254 254 254 254 254 254 254 254 0 0 0 0 1024 1024 114 115 3187 3186 0 0 0 0 0 0 0 0 0 0 0 0 0 0 0 0 
0 0 0 11 2051 2051 2051 2051 2051 2051 2051 2051 2051 2051 2051 2051 2051 2051 2051 1027 1027 1027 3083 0 0 0 0 0 0 0 0 2109 1053 2048 0 0 0 0 2081 234 234 234 234 234 234 234 234 234 234 234 234 0 0 0 0 0 0 0 0 0 0 0 0 0 0 0 0 0 0 0 0 0 0 1224 200 0 0 0 0 1057 0 0 0 0 0 0 0 0 0 3105 254 254 254 254 254 254 254 254 254 254 254 254 0 3072 2048 2048 114 115 3187 3186 0 0 0 0 0 0 0 0 0 0 0 0 0 0 0 0 0 0 
0 0 0 1057 253 253 253 253 253 253 253 253 253 253 253 253 3072 3072 0 0 0 0 0 0 0 0 0 0 0 0 0 2077 1085 2048 1024 0 0 0 2081 234 234 234 234 234 234 234 234 234 234 234 234 0 0 0 0 0 0 0 0 0 0 0 0 0 0 0 0 0 0 0 0 0 0 1224 200 0 0 0 0 3105 0 0 0 0 0 0 0 0 0 1057 254 254 254 254 254 254 254 254 254 254 254 254 1024 1024 114 115 3187 3186 0 0 0 0 0 0 0 0 0 0 0 0 0 0 0 0 0 0 0 0 
0 0 0 1057 253 253 253 253 253 253 253 253 253 253 253 253 3072 3072 0 0 0 0 0 0 0 0 0 0 0 0 0 2048 2109 1053 2048 0 0 0 2081 234 234 234 234 234 234 234 234 234 234 234 234 0 0 0 0 0 0 0 0 0 0 0 1024 1024 1024 1024 1024 1024 0 0 0 0 0 3272 2248 0 0 0 0 3105 0 0 0 0 0 0 0 0 0 1057 254 254 254 254 254 254 254 254 254 254 254 254 114 115 3187 3186 0 0 0 0 0 0 0 0 0 0 0 0 0 0 0 0 0 0 0 0 0 0 
0 0 0 1057 253 253 253 253 253 253 253 253 253 253 253 253 3072 3072 0 0 0 0 0 0 0 0 1188 164 0 0 0 0 2077 1085 0 0 1024 0 1057 234 234 234 234 234 237 234 234 234 234 234 234 0 0 0 0 0 0 114 115 2051 2051 2051 3075 3075 1139 1138 1024 1024 0 0 0 0 0 3272 2248 0 0 0 0 3105 0 0 0 0 0 0 0 0 0 2059 2051 2051 2051 2051 2051 2051 2051 2051 2051 2051 2051 2051 3187 3186 0 0 0 0 0 0 0 0 0 0 0 0 0 0 0 0 0 0 0 0 0 0 0 0 
0 0 0 1057 253 253 253 253 253 253 253 253 253 253 253 253 0 0 0 0 0 0 0 0 0 0 3236 2212 0 0 0 0 0 2059 1035 2048 2048 0 33 234 234 234 234 234 234 234 234 234 234 234 234 0 0 0 0 2048 11 3187 3186 1024 1024 1024 0 0 2162 2163 1035 3072 0 0 0 0 0 2240 3264 0 0 0 0 3105 0 0 0 0 0 0 0 0 0 0 1024 0 0 0 0 0 2048 0 0 0 0 0 0 0 0 0 0 0 0 0 0 0 0 0 0 0 0 0 0 0 0 0 0 0 0 0 0 0 
0 0 0 1057 253 253 253 253 253 253 253 253 253 253 253 253 0 0 0 0 0 0 0 0 0 0 0 0 0 0 0 2048 0 0 2059 1035 0 0 33 234 234 234 234 234 234 234 234 234 234 234 234 3072 3072 0 2048 11 3083 1024 1024 1024 1024 1024 0 0 0 0 2059 1035 3072 0 0 0 0 0 0 0 0 0 0 3105 0 0 0 0 0 0 1024 0 0 0 0 0 2048 0 0 0 0 0 0 0 0 0 0 0 0 0 0 0 0 0 0 0 0 0 0 0 0 0 0 0 0 0 0 0 0 0 0 0 
0 0 0 1057 253 253 253 253 253 251 253 253 253 253 253 253 0 0 0 0 0 0 0 0 0 0 0 0 0 0 0 2048 0 0 0 2059 1035 0 1057 234 234 234 234 234 234 234 234 234 234 234 234 3072 3072 2048 11 3083 1024 1024 1024 0 0 0 1024 1024 0 0 0 2059 1035 0 0 0 0 0 0 0 0 0 0 3105 0 0 0 0 0 0 0 1024 0 0 0 0 0 2048 0 0 0 0 0 0 0 0 0 0 0 0 0 0 0 0 0 0 0 0 0 0 0 0 0 0 0 0 0 0 0 0 0 0 
0 0 0 1057 253 253 253 253 253 253 253 253 253 253 253 253 0 0 0 0 0 0 0 0 0 0 0 0 0 0 0 0 0 0 0 0 2081 0 33 234 234 234 234 234 234 234 234 234 234 234 234 3072 2048 11 3083 0 0 1024 1024 0 0 0 1024 1024 0 0 0 0 33 0 0 0 0 0 0 0 0 0 0 3105 0 0 0 0 0 0 0 0 0 0 0 0 2048 0 0 0 0 0 0 0 0 0 0 0 0 0 0 0 0 0 0 0 0 0 0 0 0 0 0 0 0 0 0 0 0 0 0 0 
0 0 0 1057 253 253 253 253 253 253 253 253 253 253 253 253 0 0 0 0 0 0 0 0 0 0 0 0 0 0 0 0 0 0 0 0 2081 0 33 234 234 234 234 234 234 234 234 234 234 234 234 3072 11 3083 3072 0 0 1024 1024 0 0 0 1024 1024 0 0 0 0 33 0 0 0 0 0 0 0 0 0 0 3105 0 0 0 0 0 0 0 0 0 0 0 0 2048 0 0 0 0 0 0 0 0 0 0 0 0 0 0 0 0 0 0 0 0 0 0 0 0 0 0 0 0 0 0 0 0 0 0 0 
0 0 0 1057 253 253 253 253 253 253 253 253 253 253 253 253 0 0 0 0 114 115 2051 2051 2051 2051 2051 1027 1027 1027 1027 1027 1027 1027 1027 1027 3083 0 33 234 234 234 234 234 234 234 234 234 234 234 234 11 3083 1024 1024 0 0 0 0 0 0 0 1024 1024 0 0 0 0 2059 1027 2051 3075 3075 3 1027 1027 2051 2051 3075 3083 0 0 0 0 0 0 0 0 0 0 0 0 0 0 0 0 0 0 0 0 0 0 0 0 0 0 0 0 0 0 0 0 0 0 0 0 0 0 0 0 0 0 0 0 0 0 0 0 
0 0 0 1057 253 253 253 253 253 253 253 253 253 253 253 253 0 0 114 115 3187 3186 1024 1024 0 0 0 0 0 0 0 0 0 0 0 0 0 0 2059 1027 2051 2051 3075 3075 3075 3075 3075 3075 3 1027 3075 3083 1024 0 0 0 0 0 0 0 0 0 0 0 0 0 0 0 0 0 0 0 0 0 0 0 0 0 0 0 0 0 0 0 0 0 0 0 0 0 0 0 0 0 0 0 0 0 0 0 0 0 0 0 0 0 0 0 0 0 0 0 0 0 0 0 0 0 0 0 0 0 0 0 0 0 0 0 
0 0 0 1057 253 253 253 253 253 253 253 253 253 253 253 253 0 11 3187 3186 1024 1024 1024 0 0 0 0 0 0 0 0 0 0 0 0 0 0 0 0 0 0 0 0 0 0 0 0 0 0 0 0 0 0 0 0 0 0 0 0 0 0 0 0 0 0 0 0 0 0 0 0 0 0 0 0 0 0 0 0 0 0 0 0 0 0 0 0 0 0 0 0 0 0 0 0 0 0 0 0 0 0 0 0 0 0 0 0 0 0 0 0 0 0 0 0 0 0 0 0 0 0 0 0 0 0 0 0 0 
0 0 0 1057 253 253 253 253 253 253 253 253 253 253 253 253 11 3083 1024 1024 1024 1024 1024 0 0 0 0 0 0 0 0 0 0 0 0 0 0 0 0 0 0 0 0 0 0 0 0 0 0 0 0 0 0 0 0 0 0 0 0 0 0 0 0 0 0 0 0 0 0 0 0 0 0 0 0 0 0 0 0 0 0 0 0 0 0 0 0 0 0 0 0 0 0 0 0 0 0 0 0 0 0 0 0 0 0 0 0 0 0 0 0 0 0 0 0 0 0 0 0 0 0 0 0 0 0 0 0 0 
0 0 0 2059 2051 2051 2051 2051 2051 2051 2051 2051 2051 2051 2051 2051 3083 1024 1024 1024 1024 1024 0 0 0 0 0 0 0 0 0 0 0 0 0 0 0 0 0 0 0 0 0 0 0 0 0 0 0 0 0 0 0 0 0 0 0 0 0 0 0 0 0 0 0 0 0 0 0 0 0 0 0 0 0 0 0 0 0 0 0 0 0 0 0 0 0 0 0 0 0 0 0 0 0 0 0 0 0 0 0 0 0 0 0 0 0 0 0 0 0 0 0 0 0 0 0 0 0 0 0 0 0 0 0 0 0 0 
0 0 0 0 0 0 0 0 0 0 0 0 0 0 0 0 1024 1024 1024 0 0 0 0 0 0 0 0 0 0 0 0 0 0 0 0 0 0 0 0 0 0 0 0 0 0 0 0 0 0 0 0 0 0 0 0 0 0 0 0 0 0 0 0 0 0 0 0 0 0 0 0 0 0 0 0 0 0 0 0 0 0 0 0 0 0 0 0 0 0 0 0 0 0 0 0 0 0 0 0 0 0 0 0 0 0 0 0 0 0 0 0 0 0 0 0 0 0 0 0 0 0 0 0 0 0 0 0 0 
0 0 0 0 0 0 0 0 0 0 0 0 0 0 0 0 0 0 0 0 0 0 0 0 0 0 0 0 0 0 0 0 0 0 0 0 0 0 0 0 0 0 0 0 0 0 0 0 0 0 0 0 0 0 0 0 0 0 0 0 0 0 0 0 0 0 0 0 0 0 0 0 0 0 0 0 0 0 0 0 0 0 0 0 0 0 0 0 0 0 0 0 0 0 0 0 0 0 0 0 0 0 0 0 0 0 0 0 0 0 0 0 0 0 0 0 0 0 0 0 0 0 0 0 0 0 0 0 
